KY ./assets/key_small3.xpm
WDO ./assets/wall_no_door.xpm
WD ./assets/wall_door.xpm
FL ./assets/0_floor.xpm
CE ./assets/0_ceiling.xpm
WA ./assets/0_wall.xpm
WDO1 ./assets/wall_no_door.xpm
WD1 ./assets/wall_door.xpm
FL1 ./assets/floor.xpm
CE1 ./assets/ceiling_with_light.xpm
WA1 ./assets/wall2.xpm

                111111
                100001
                10S0O1
                100001
                101001
                101001
        111111111D111111111111111
        1000000010100000111111001
        100000O000010000111111001
        1000000000000000000000001
        1011110101010000001111111
        100111010010000000D000001
11111111101111D111100000001111111
100000000011100111110111000001001
111101111111110111000000100011111
11110111111111O11101010010001
11000111110101011100000010001
10000000000000001100000010001
1001111111D100001101010010001
110000011101010111110110D000111
11110111 1110101 101111010001
11111111 1111111 111111111111