KY ./assets/key_small3.xpm
WDO ./assets/wall_no_door.xpm
WD ./assets/wall_bonus.xpm
FL ./assets/0_floor.xpm
CE ./assets/0_ceiling.xpm
WA ./assets/0_wall.xpm
WDO1 ./assets/wall_no_door.xpm
WD1 ./assets/1_wall_door.xpm
FL1 ./assets/floor.xpm
CE1 ./assets/ceiling_with_light.xpm
WA1 ./assets/wall2.xpm
WDO2 ./assets/2_no_door.xpm
WD2 ./assets/2_door.xpm
FL2 ./assets/2_floor_water.xpm
CE2 ./assets/wall_bathroom.xpm
WA2 ./assets/wall_bathroom.xpm
WDO3 ./assets/3_no_door.xpm
WD3 ./assets/3_door.xpm
FL3 ./assets/3_floor.xpm
CE3 ./assets/3_ceiling.xpm
WA3 ./assets/3_wall.xpm

                111111
                1000S1
                100001
                1010K1
        111111111D111111111111111
111111111000000010100000000000001
111010001000000000000000111000001
100000100000001000001000000110001
100000010000000000000000000000001
10000001000000100000100000011111
10000001000011111111111100000001
100000010000000000000000000000001
100000010000111111111000000000001
111111111011111111101010000001111
        1001110000100010000000001
11111111101111D101100000001111111
100000000011100101110111000001001
111101111111110101000000100011111
111111111111K0010101010010001
11000111110100000000000010001
10000000000001D11100000010001
10011111111101010101010010001
10011111111101010101010010111
10011111111101010101010010001
10011111111101010101010010001
11111111111111011111111111111
10000000000000000000100000001
10000000000001110000001000K01
1000011111111111111111111111111111
10000000001100010D0000000000000001
100000000010010001110011111111100111111
111101000000011111110000000000000D00001
10000100001011111110001111111110011111
1000010000101111111000000000000001
1111111111111111111111111111111111
