NO ./assets/wall_door.xpm
SO ./assets/floor.xpm
WE ./assets/ceiling_with_light.xpm
EA ./assets/wall2.xpm

F 130,130,130
C 0,160,220


        1111111111111111111111111
        1000000000110000111111001
        1011100111111100011111111
        1001100000000D01E000D0011
111111111011100111111100011111111
100000000011100111110111111111111
11110111111111011100000010001
11110111111111011101010010001
11000111110101011100000010001
10000000000000001100000010001
1001111111D100001101010010001
110000011101010111110110D000111
11110111 1110101 101111010001
11111111 1111111 111111111111