NO ./assets/rook.xpm
SO ./assets/greystone.xpm
WE ./assets/wood.xpm
EA ./assets/mossy.xpm

F 130,130,130
C 0,160,220

        1111111111111111111111111
        1000000000110000111111001
        1011100111111100100011001
        1001100000000001000000001
111111111011100111111100000000001
100000000011100111110111000001001
111101111111110111000000100011111
11110111111111011101010010001
11000111110101011100000010001
10000000000000001100000010001
10011111110100001101010010101
11000001110101011111011001N1111
11110111 1110101 101111010101
11111111 1111111 111111111111
