NO ./path_to_the_north_texture
SO ./path_to_the_south_texture
WE ./path_to_the_west_texture
EA ./path_to_the_east_texture

F 255,100,0
C 225,100,0

         11111111111111111111111
        1000000000110000000000001
        1011000001110000000000001
        1001000000000000000000001
 11111111011000001110000000000001
10000000001100000111011111111111
11110111111111011100000010001
11110111111111011111010010001
11000000110101011 10000001001
100000000N0000001110000010001
10000000000000001101010010001
110000011101010111110111100111
11110111 1110101 101111010001
 111111   11111   1111111111
