NO ../assets/wall.xpm
SO ../assets/wall.xpm
WE ../assets/wall.xpm
EA ../assets/wall.xpm

F 255,100,0
C 225,100,0

        1111111111111111111111111
        1000000000110000000000001
        1011000001110000000000001
        100100S000000000000000001
111111111011000001110000000000001
100000000011000001110111111111111
11110111111111011100000010001
11110111111111011111010010001
11000000110101011 10000001001
10000000000000001110000010001
10000000000000001101010010001
110000011101010111110111100111
11110111 1110101 101111010001
 111111   11111   1111111111
