NO ./assets/colorstone.xpm
SO ./assets/greystone.xpm
WE ./assets/mossy.xpm
EA ./assets/wood.xpm

F 156,156,156
C 0,170,228

        1111111111111111111111111
        1000000000110000000000001
        1011000000000000000000001
        100100N011111000000000001
11111111101100001  11000000000001
100000000011000011111111111111111
11110111111111011100000010001
11110111111111011111010010001
11000000110101011 10000001001
10000000000000001110000010001
10000000000000001101010010001
110000011101010111110111100111
11110111 1110101 101111010001
1111111   11111   1111111111
