NO ./assets/door.xpm
SO ./assets/floor.xpm
WE ./assets/ceiling.xpm
EA ./assets/wall2.xpm

F 130,130,130
C 0,160,220


        1111111111111111111111111
        1000000000110000000000001
        1011000001110000000000001
        1001000000000000000000001
111111111011000001110000000000001
10000000001100000111011111D111111
11110111111111011100000010001
11110111111111011101010010001
11000000110101011100000010001
10000000000000001100000010001
10000000000000001101010010001
110000011101010111110110D0N0111
11110111 1110101 101111010001
11111111 1111111 111111111111
