NO ../assets/wall.xpm
SO ../assets/wall.xpm
WE ../assets/wall.xpm
EA ../assets/wall.xpm

F 255,100,0
C 225,100,0

11111111111111111111111111111111
10000000000000110000000000000001
10000000000000000000000000000001
10000000001110000000000000000001
10001000000000000000011110000001
10001000000000000000000000000001
10001000000000000000000010000001
10001000000000N00000000011000001
10000000000000000000011110000001
10000000010000000000000000000001
10000000011100000000000000000001
10000000010000000000000010000001
10000000000000000000000010000001
10000000000000000011111110000001
10000111110000000000000000000001
11111111111111111111111111111111