NO ../assets/wall.xpm
SO ../assets/wall.xpm
WE ../assets/wall.xpm
EA ../assets/wall.xpm

F 255,100,0
C 225,100,0

111111111111111111111111111111
100000000000001100000000000001
100000000000000000000000000001
100000000011100000000000000001
100010000000000000000111100001
100010000000000000000000000001
100010000000000000000000100001
10001000000000N000000000110001
100000000000000000000111100001
100000000100000000000000000001
100000000111000000000000000001
100000000100000000000000100001
100000000000000000000000100001
100000000000000000111111100001
100001111100000000000000000001
100000000000000000000000000001
111111111111111111111111111111