
		1111111111111111111111111
		1001E00000110000000000001
		1111000001110000000000001
		1001000001000000000000001
111111111011000001110000000000001
10000000001100111110111111111111
11110111111111111100000010001
111101111111111  11101010010011
110000001101111  1100000010001
100000000000001  1000000100011
1000000000000011110101001000101
11000001110101011111011110N000000000001
11110111 1110101 1011110100000000000001
11111111 1110111 1111111111111111111111

//split de \0 && '\n'
// Los 0 se comprueban si tienen alrededor un \0 && '\n' && ' '
// Que No haya mas the un salto de 1 '\n'


NO ./path_to_the_north_texture
SO ./path_to_the_south_texture
WE ./path_to_the_west_texture
EA ./path_to_the_east_texture
F 220,100,0
C 225,30,0

// comprobar que datos existan
// formatos correctos
// exista archivo
// no haya duplicados
// rango de colores correcto max = 255 min = 0

// si no, return "Error\n"